First line: #rows, #columns, optional delay, optional chamber size. Other lines: U-free, W-wall, D-dragon, L-lava, C-Cacti, S-Initial, E-Exit
20 20
W W W W W W W W W W W W W W W W W W W W
 W W S U W W W U U U U W W W U U W W W W
W W U W U W W W U W U W W U U W W U U W 
 W U W W U U W W U U W W U W W W W U W W
W W U W W U U W W C W W U W W W W U W W
 W W U W U W U U U W W U U W W W U W W W
W W W U U W W W W L W W U U W W W U W W
 W W U W W W W W W U W U W U W W W U W W
W W U W W U U W W W U U W W U U U U W W
 W U W W U W U W W W W W U U W W W W W W
W W U W U W U U U U W W W U U U U U U W
 W W U U W W W W W U U U U W W W W W U W
W W U W W W W W U U W W W W L U W W U W
 W W U U U W W U W U U E U U W U U U W W
W W C W W U U L W U W W W W W C W W W W
 W W U W W U U W W U W W W W U W W W W W
W W U W W W U U W W U U U W U U U W W W
 W U W W W W U W U W W W U U W W U W W W
W W U U U U U U U U W W U W W W W U W W
 W W W W W W W W W W W W W W W W W W W W